41 32
KKKKKKKKKKKKKKKKKK###KKKKKKKKKKKKKKKKKKKK
KKKKKKKKKKKKKKKKK #3# KKKKKKKKKKKKKKKKKKK
KKKKKKKKKKKKKKKKKK###KKKKKKKKKKKKKKKKKKKK
KKKKKKKKKKKKKKKKKKKKKKKKKKKKKKKKKKKKKKKKK
KKKKKKKKKKKKKKKKKKKKKKKKKKKKKKKKKKKKKKKKK
KKKKKKKKKKKKKKKKKKKKKKKKKKKKKg  g  gKKKKK
KKKKKK......................KKKKKKKKKKKKK
KKKKKKKKKKKKKK.KKKKKKKKKKKKKK  KKK xKKKKK
KKKKKg x K.K..........ÆK K  KKKKKKKKKKKKK
KKKKKg   K.....K.......KKKKKK......KKKKKK
KKKKK    KKKp..K...b.......u....E..KKKKKK
KKKKK KKKK.K...K.jm....KKKKKK..z...KKKKKK
KKKKK K....K...K.......K KK K..h...KKKKKK
KKKKK K....K...K..@zu..K KK K..h...KKKKKK
KKKKK K.KKKK.......h...K K  K......KKKKKK
KKKKK K.........b......K  K K...a..KKKKKK
KKKKK K.K..KKKKK..KKKKKK KK KKK..KKKKKKKK
KKKKK KKK.K x  K..Kggx  KKK x K..KKKKKKKK
KKKKK   K.K    K..Kg   KKKK   K..KxKKKKKK
KKKKKK  K.K   xK..KKKKKKKKKKKKK..KKKKKKKK
KKKKKK  K.KKKKKK..KKKK  K   K.l....KKKKKK
KKKKKKKKK...KK.......Kg  K  K.K....KKKKKK
KKKKKKK.K.K.KK.......Kgg  K K.K.KK.KKKKKK
KKKKKKK...K..K.......Kg  K  K.K....KKKKKK
KKKKKKKKKKKK.K.......K  K   K.K.KK.KKKKKK
KKKKKKKKKKK..K.K....kK K    K.K....KKKKKK
KKKKK    KK.KK.K....kK  K   K......KKKKKK
KKKKKx   KKKKKKKKKKKKKx  KKKKKKKKKKKKKKKK
KKKKKKKKKKKKKKKKKKKKKKKKKKKKKKKKKKKKKKKKK
KKKKKKKKKKKKKKKKKKKKKKKKKKKKKKKKKKKKKKKKK
KKKKKKKKKKKKKKKKKKKKKKKKKKKKKKKKKKKKKKKKK
KKKKKKKKKKKKKKKKKKKKKKKKKKKKKKKKKKKKKKKKK
KKKKKKKKKKKKKKKKKKKKKKKKKKKKKKKKKKKKKKKKK
